#
# Map: Map
# Size: Large (20x14)
#

TE TE TE TE TE TR TE TE TE TE TE RE TE TE TE TE TE TE TE TE
TE TE TE TE TE TR TE TE TE TE TE RE TE TE TE TE TE TE TE TE
TE TE TE TE TE TR TR TR TR TR TR RR TR TR TR TE TE TE TE TE
TE TE TE TE TE TR TE TE TE TE TE RE TE TE TR TE TE TE TE TE
TE TE TE TE TE TR TE TE TE TE TE RE RE TE TR TE TE TE TE TE
TE TE TE TE TE TR TE TE TE TE TE TE RE TE TR TR TR TR TE TE
TE TE TE TE TE TR TE TE TE TE TE TE RE TE TE TE TE TE TE TE
TE TE TE TE TE TR TE TE TE TE TE TE RE TE TE TE TE TE TE TE
TE TE TR TR TR TR TE TE TE TE TE TE RE RE TE TE TE TE TE TE
TE TE TR TE TE TR TE TE TE TE TE TE LE LE LE LE LE LE LE LE
TE TE TR TE TE TR TE TE TE TE TE LE LE LE LE LE LE LE LE LE
TE TE TR TE TE TR TE TE TE TE LE LE LE LE LE LE LE LE LE LE
TE TE TR TE TE TR TE TE TE TE LE LE LE LE LE LE LE LE LE LE
TE TE TR TE TE TR TE TE TE TE LE LE LE LE LE LE LE LE LE LE
