#
# Map: Map
# Size: Large (20x14)
#

TE TE TE TE TE TR TE TE TE TE TE WE TE TE TE TE TE TE TE TE
TE TE TE TE TE TR TE TE TE TE TE WE TE TE TE TE TE TE TE TE
TE TE TE TE TE TR TR TR TR TR TR WR TR TR TR TE TE TE TE TE
TE TE TE TE TE TR TE TE TE TE TE WE TE TE TR TE TE TE TE TE
TE TE TE TE TE TR TE TE TE TE TE WE WE TE TR TE TE TE TE TE
TE TE TE TE TE TR TE TE TE TE TE TE WE TE TR TR TR TR TE TE
TE TE TE TE TE TR TE TE TE TE TE TE WE TE TE TE TE TE TE TE
TE TE TE TE TE TR TE TE TE TE TE TE WE TE TE TE TE TE TE TE
TE TE TR TR TR TR TE TE TE TE TE TE WE WE TE TE TE TE TE TE
TE TE TR TE TE TR TE TE TE TE TE TE WE WE WE WE WE WE WE WE
TE TE TR TE TE TR TE TE TE TE TE WE WE WE WE WE WE WE WE WE
TE TE TR TE TE TR TE TE TE TE WE WE WE WE WE WE WE WE WE WE
TE TE TR TE TE TR TE TE TE TE WE WE WE WE WE WE WE WE WE WE
TE TE TR TE TE TR TE TE TE TE WE WE WE WE WE WE WE WE WE WE
